XXXXXXXXXXXXXXXXXXXXXXXXXXXXXXXXXXXXXXXXXXXXXXXXXXXXXXXXXXXXXX**************************                                   
XXXXXXXXXXXXXXXXXXXXXXXXXXXXXXXXXXXXXXXXXXXXXXXXXXXXXXXXXXXXX*XXXXXXXXXXXXXXXXXXXXXXXXXX*XXXXXXXXXXXXXXXXXXXXXXXXXXXXXXXXXX
X*3333333333X3333333333*******************************1X33333X********************XX33331********************************1X
X3*333333333X333333333*XXXXXXXXXXXXXXXXXXXXXXXXXXXXXXX*XXXXXXXXXXXXXXXXXXXXXXXXXXX*XXXXXXXXXXXXXXXXXXXXXXXXXXXXXXXXXXXXXX*X
X33*33333333X33332333*3X3333333331********************1X333333********************XX3333333333333333331******************1X
X333*3333333X3333333*33X333333333*XXXXXXXXXXXXXXXXXXXXXX33333*XXXXXXXXXXXXXXXXXXXXXX333333333333333333*3333333333333333333X
X3333*333233X333333*333X333333333*333333333333333333333X33333*333333323333333333333X333333333333333333*3333333333333333333X
X33333*33333X33333*3333X333333333*333333333323333333333X33333*333333333332333333333X333333333333333333*3333333332333333333X
X333333*3333X3333*33333X333333333*333333133333333333333X33333*333332333333333333333X333333333333333333*3333333333333333333X
X3333333*333X333*333333X333333333*333333333233332333333X33333*333333333133323333333X333333333333333333*3333333333333333333X
X33333333*33X33*3333333X333333333*333331333333133333333X33333*333233333332233333333X333333333333333333*3333333333333133333X
X3333X3333*3X3*33333333X333333333*333333223332333333333X33333*333333332333333333333X333333133333333333*3333333333333333333X
X3333333333*X*3333X3333X333333333*333323333333323333333X33333*333133333333323333333X333333332333333333*3333333333233333333X
X3333X33333*X*333333333X333333333*333333331333333333333X33333*333333333333333333333X333333333X33333333*3333333333333333333X
X3333333333*X*333133X33X3333333331********************XX333331********************XX333333333333333333*3333333323333333333X
X3X33313333*X*333333333X33333333XXXXXXXXXXXXXXXXXXXXXX*XXXXXXXXXXXXXXXXXXXXXXXXXXX*X333333333333333333*3333333333333333333X
X333333X333*X*333331333XXXXXXXXXX1********************XX333331********************XX333333333332XXX333*3333333333133333333X
X3333333333*X*333333333X333333333*XXXXXXXXXXXXXXXXXXXXXX33333*XXXXXXXXXXXXXXXXXXXXXX333333333333333333*3333333333333333333X
X3333333X33*X*33X333333X333333333*333333333333333333333X33333*333333333333333333333X333333333333333333*3333333333X33333333X
X32333X3333*X*333333333X333333333*333333333X33333333333X33333*333333331333331333333X333333333332333333*3333333333333333333X
X3333333333*X*33X331333X333333333*333333233333333333333X33333*333313333333333333333X333333332333333333*3333333333333333333X
X3333333333*X*333333333X333333333*333333333333333333333X33333*3333333333233c3333333X333333333333333333*3323333333333333333X
X3333333333*X*333133333X333333333*333333331333322333333X33333*333333313333332333333X33333333X333333333*33333333X3333333333X
X3333233333*X*333323X33X333333333*333333333332333333333X33333*333323333323333333333X333333333333333333*3333333333333333333X
X3333333X33*X*333333333X333333333*333332333333333333333X33333*333333333333333333333X333333333333323333*3333333333333333333X
X3332333333*X*3333X3333X333333333*33333333333333X333333X33333*333313333333233333333X333333333333333333*3333333333333333333X
X3233333333*X*333333333X333333333*333333333332333333333X33333*333333333333333333333X333333333133333333*3333333333X33333333X
X3313333233*X*33323X333X3333333331********************XX333331********************XX333333333332333333*3333333333333333333X
Xb333233333*X*333333333XXXXXXXXXXXXXXXXXXXXXXXXXXXXXXX*XXXXXXXXXXXXXXXXXXXXXXXXXXX*X333333333333333333*3333333333333333333X
X33333X3333X*X333333333X3333333331********************XX33333*********************XX333333333333333333*3333333333333333333X
XXXXXXXXXXXXXXXXXXXXXXXXXXXXXXXXX*XXXXXXXXXXXXXXXXXXXXXXXXXX*XXXXXXXXXXXXXXXXXXXXXXdXXXXXXXXXXXXXXXXXXXXXXXXXXXXXXXXXXXXXXX
XXXXXXXXXXXXXXXXXXXXXXXXXXXXXXXXXX**************************                                                               

