XXXXXXXXXXXXXXXXXXXXXXXXXXXXXXXXXXXXXXXXXXXXXXXXXXXXXXXXXXXXXX11111111111111111111111111
XXXXXXXXXXXXXXXXXXXXXXXXXXXXXXXXXXXXXXXXXXXXXXXXXXXXXXXXXXXXX1XXXXXXXXXXXXXXXXXXXXXXXXXX1XXXXXXXXXXXXXXXXXXXXXXXXXXXXXXXXXX
Xa3333333333X333333333311111111111111111111111111111111X33333X11111111111111111111XX33331111111111111111111111111111111111X
X31333333333X3333333331XXXXXXXXXXXXXXXXXXXXXXXXXXXXXXX1XXXXXXXXXXXXXXXXXXXXXXXXXXX1XXXXXXXXXXXXXXXXXXXXXXXXXXXXXXXXXXXXXX1X
X33133333333X3333233313X3333333331111111111111111111111X33333311111111111111111111XX33333333333333333311111111111111111111X
X33313333333X3333333133X3333333331XXXXXXXXXXXXXXXXXXXXXX333331XXXXXXXXXXXXXXXXXXXXXX33333333333333333313333333333333333333X
X33331333233X3333331333X3333333331333333333333333333333X333331333333323333333333333X33333333333333333313333333333333333333X
X33333133333X3333313333X3333333331333333333323333333333X333331333333333332333333333X33333333333333333313333333332333333333X
X33333313333X3333133333X3333333331333333133333333333333X333331333332333333333333333X33333333333333333313333333333333333333X
X33333331333X3331333333X3333333331333333333233332333333X333331333333333133323333333X33333333333333333313333333333333333333X
X33333333133X3313333333X3333333331333331333333133333333X333331333233333332233333333X33333333333333333313333333333333133333X
X3333X333313X3133333333X3333333331333333223332333333333X333331333333332333333333333X33333313333333333313333333333333333333X
X33333333331X13333X3333X3333333331333323333333323333333X333331333133333333323333333X33333333233333333313333333333233333333X
X3333X333331X1333333333X3333333331333333331333333333333X333331333333333333333333333X333333333X3333333313333333333333333333X
X33333333331X1333133X33X333333333111111111111111111111XX33333111111111111111111111XX33333333333333333313333333323333333333X
X3X333133331X1333333333X33333333XXXXXXXXXXXXXXXXXXXXXX1XXXXXXXXXXXXXXXXXXXXXXXXXXX1X33333333333333333313333333333333333333X
X333333X3331X1333331333XXXXXXXXXX111111111111111111111XX33333111111111111111111111XX333333333332XXX33313333333333133333333X
X33333333331X1333333333X3333333331XXXXXXXXXXXXXXXXXXXXXX333331XXXXXXXXXXXXXXXXXXXXXX33333333333333333313333333333333333333X
X3333333X331X133X333333X3333333331333333333333333333333X333331333333333333333333333X33333333333333333313333333333X33333333X
X32333X33331X1333333333X3333333331333333333X33333333333X333331333333331333331333333X33333333333233333313333333333333333333X
X33333333331X133X331333X3333333331333333233333333333333X333331333313333333333333333X33333333233333333313333333333333333333X
X33333333331X1333333333X3333333331333333333333333333333X3333313333333333233c3333333X33333333333333333313323333333333333333X
X33333333331X1333133333X3333333331333333331333322333333X333331333333313333332333333X33333333X333333333133333333X3333333333X
X33332333331X1333323X33X3333333331333333333332333333333X333331333323333323333333333X33333333333333333313333333333333333333X
X3333333X331X1333333333X3333333331333332333333333333333X333331333333333333333333333X33333333333332333313333333333333333333X
X33323333331X13333X3333X333333333133333333333333X333333X333331333313333333233333333X33333333333333333313333333333333333333X
X32333333331X1333333333X3333333331333333333332333333333X333331333333333333333333333X33333333313333333313333333333X33333333X
X33133332331X133323X333X333333333111111111111111111111XX33333111111111111111111111XX33333333333233333313333333333333333333X
Xb3332333331X1333333333XXXXXXXXXXXXXXXXXXXXXXXXXXXXXXX1XXXXXXXXXXXXXXXXXXXXXXXXXXX1X33333333333333333313333333333333333333X
X33333X3333X1X333333333X333333333111111111111111111111XX33333111111111111111111111XX333333333333333333e3333333333333333333X
XXXXXXXXXXXXXXXXXXXXXXXXXXXXXXXXX1XXXXXXXXXXXXXXXXXXXXXXXXXX1XXXXXXXXXXXXXXXXXXXXXXdXXXXXXXXXXXXXXXXXXXXXXXXXXXXXXXXXXXXXXX
XXXXXXXXXXXXXXXXXXXXXXXXXXXXXXXXXX11111111111111111111111111